11222211
12211221
22114122
20141612
21613112
22131122
12211221
11222211