11222211
22204222
25141612
21503162
22231222
11222211