112222222
222111112
211111112
226222122
121211612
121111112
122222222