1 1 2 2 2 2 1 1
2 2 2 1 4 2 2 2
2 5 1 4 1 6 1 2
2 1 5 0 3 1 6 2
2 2 2 3 1 2 2 2
1 1 2 2 2 2 1 1